1111
1E01
11101
   101
    101
     101
      1