
1111111
1100S11
111011
1110111
1111111