11111111
   110N01
111110111
111110111
111110001
111111111