1111
1001
11101
   101
    101
     101
      1