
1111111
1100011
111011
1110111
1111111