11111111111111
1110000000N0111
1111111101111111
        1