111111
1   1N1
1111101
1000001
1111111