111111111111
10000 00W 01
111111111111