


11111
101E1111
1111111




