111111111111111111111
1111111             1
1
111111111111111111111
1S11
11