11111
1      11
1     10W1
111111111

      