NO ./assets/textures/doom_hexagone.xpm
SO ./assets/textures/doom_hexagone.xpm
EA ./assets/textures/doom_hexagone.xpm
WE  ./assets/textures/doom_hexagone.xpm
C ./assets/textures/doom_ground.xpm
F ./assets/textures/doom_ground.xpm

111111111111111111111111111111111111111111111111111111111
100000000000000000000000000000000000000000000000000000001
100000000000000000000000000000000000000000000000000000001
100000000000000000000000000000000000000000000000000000001
100000000000000000000000000000000000000000000000000000001
100000000000000000000000000000000000000000000000000000001
100000111110000001111100000000011111111111111100000000001
100000111110000001111100000000000000000000011111000000001
100000111110000001111100000000000000000000011111000000001
1000001111100000011111000000S0000000000000011111000000001
100000111111111111111100000000000011111111111100000000001
100000001111111111111100000000011111110000000000000000001
100000000000000011111100000000011111100000000000000000001
100000000000000001111100000000011111100000000000000000001
100000000000000000111100000000011111111111111111100000001
100000000000000000000000000000000000000000000000000000001
100000000000000000000000000000000000000000000000000000001
100000000000000000000000000000000000000000000000000000001
100000000000000000000000000000000000000000000000000000001
100000000000000000000000000000000000000000000000000000001
111111111111111111111111111111111111111111111111111111111
