NO ./assets/textures/backroom_wall2.xpm
SO ./assets/textures/backroom_wall2.xpm
EA ./assets/textures/backroom_wall2.xpm
WE ./assets/textures/backroom_wall2.xpm
F ./assets/textures/ground1.xpm
C ./assets/textures/backroom_ceiling.xpm
D ./assets/textures/haaaaa.xpm
2 ./assets/textures/sprites/skull/skull1.xpm ./assets/textures/sprites/skull/skull2.xpm ./assets/textures/sprites/skull/skull3.xpm ./assets/textures/sprites/skull/skull4.xpm ./assets/textures/sprites/skull/skull5.xpm ./assets/textures/sprites/skull/skull6.xpm ./assets/textures/sprites/skull/skull7.xpm ./assets/textures/sprites/skull/skull8.xpm
3 ./assets/textures/w3d_lamp.xpm
4 ./assets/textures/sprites/burning_barrel/burning_barrel1.xpm ./assets/textures/sprites/burning_barrel/burning_barrel2.xpm ./assets/textures/sprites/burning_barrel/burning_barrel3.xpm
5 ./assets/textures/sprites/exploding_barrel/exploding_barrel5.xpm ./assets/textures/sprites/exploding_barrel/exploding_barrel2.xpm ./assets/textures/sprites/exploding_barrel/exploding_barrel3.xpm ./assets/textures/sprites/exploding_barrel/exploding_barrel4.xpm ./assets/textures/sprites/exploding_barrel/exploding_barrel5.xpm
6 ./assets/textures/sprites/red_torch/red_torch1.xpm ./assets/textures/sprites/red_torch/red_torch2.xpm ./assets/textures/sprites/red_torch/red_torch3.xpm ./assets/textures/sprites/red_torch/red_torch4.xpm
7 ./assets/textures/sprites/monster/monster1.xpm ./assets/textures/sprites/monster/monster2.xpm ./assets/textures/sprites/monster/monster3.xpm ./assets/textures/sprites/monster/monster4.xpm ./assets/textures/sprites/monster/monster5.xpm ./assets/textures/sprites/monster/monster6.xpm ./assets/textures/sprites/monster/monster7.xpm ./assets/textures/sprites/monster/monster8.xpm ./assets/textures/sprites/monster/monster7.xpm ./assets/textures/sprites/monster/monster8.xpm
DARK 1

11111111111111111111111111111111111111111
10000000000000000000000000000000000000001
10000000000000000000000000000000000000001
10000000000000000000100000000000000000001
10000000000000000000100000000000000000001
10000000000500000000100000000050000000001
10000000000000000000100000000000000000001
10000000000000000000100000000000000000001
10000000000000000000100000000000000000001
10000000000000000000100000000000000000001
10000000000500000000100000000050000000001
10000000000000000000100000000000000000001
10000000000000000000100000000000000000001
10000000000000000000000000000000000000001
10201000000000000000000000000000000010201
1020D0000000200000000000000020000000D0201
10201000000000000001010000000000000010201
1000111111d1111110010100111111d1111110001
10000060000010401011011010401000006000001
10000000000000001110301110000000000000001
160111d1111000000030N0300000001111d111061
10000000000000001110001110070000000000001
10000060000010401011311010401000006000001
10001111111d11111001010011111d11111110001
10201000000000000001010000000000000010201
1020D0000000200000000000000020000000D0201
10201000000000000000000000000000000010201
10000000000000000000000000000000000000001
10000000000000000000100000000000000000001
10000000000000000000100000000000000000001
10000000600500600000100000060050060000001
10000000000000000000100000000000000000001
10000000000000000000100000000000000000001
10000000000000000000100000000000000000001
10000000000000000000100000000000000000001
10000000600500600000100000060050060000001
10000000000000000000100000000000000000001
10000000000000000000100000000000000000001
10000000000000000000000000000000000000001
10000000000000000000000000000000000000001
10000000000000000000000000000000000000001
11111111111111111111111111111111111111111