NO ./assets/textures/doom_hexagone.xpm
SO ./assets/textures/doom_hexagone.xpm
EA ./assets/textures/doom_hexagone.xpm
WE ./assets/textures/doom_hexagone.xpm
F ./assets/textures/doom_ground.xpm
C ./assets/textures/doom_grid.xpm
D ./assets/textures/doom_hexagone.xpm
2 ./assets/textures/sprites/skull/skull1.xpm ./assets/textures/sprites/skull/skull2.xpm ./assets/textures/sprites/skull/skull3.xpm ./assets/textures/sprites/skull/skull4.xpm ./assets/textures/sprites/skull/skull5.xpm ./assets/textures/sprites/skull/skull6.xpm ./assets/textures/sprites/skull/skull7.xpm ./assets/textures/sprites/skull/skull8.xpm
3 ./assets/textures/w3d_lamp.xpm
4 ./assets/textures/sprites/burning_barrel/burning_barrel1.xpm ./assets/textures/sprites/burning_barrel/burning_barrel2.xpm ./assets/textures/sprites/burning_barrel/burning_barrel3.xpm
5 ./assets/textures/sprites/exploding_barrel/exploding_barrel5.xpm ./assets/textures/sprites/exploding_barrel/exploding_barrel2.xpm ./assets/textures/sprites/exploding_barrel/exploding_barrel3.xpm ./assets/textures/sprites/exploding_barrel/exploding_barrel4.xpm ./assets/textures/sprites/exploding_barrel/exploding_barrel5.xpm
6 ./assets/textures/sprites/red_torch/red_torch1.xpm ./assets/textures/sprites/red_torch/red_torch2.xpm ./assets/textures/sprites/red_torch/red_torch3.xpm ./assets/textures/sprites/red_torch/red_torch4.xpm
DARK 1

11111111111111111111111111111111111111111
10000000000000000000000000000000000000001
10005000000000000000100000000000000050001
10000000000000000000100000000000000000001
10000000000000000000100000000000000000001
10000000000000000003D30000000000000000001
10000000000000000000100000000000000000001
10000000000000000000100000000000000000001
10000000000000000000100000000000000000001
10000000100000000000000000000000100000001
10000000010000000000000000000001000000001
10000000001000000000000000000010000000001
10000000000100000000000000000100000000001
10000000000010000000000000001000000000001
10000000000001000000000000010000000000001
10000002000000100000000000100000002000001
10000000000000010000000001000000000000001
10000000000000001600000610000000000000001
10000000000000000000000000000000000000001
10000000000300000040004000000300000000001
10000000011d11100000N00000111d11000000001
10000000000300000040004000000300000000001
10000000000000000000000000000000000000001
10000000000000000000000000000000000000001
10000000000000001600000610000000000000001
10000002000000010000000001000000020000001
10000000000000100000000000100000000000001
10000000000001000000000000010000000000001
10000000000010000000000000001000000000001
10000000000100000000000000000100000000001
10000000001000000000000000000010000000001
10000000010000000000000000000001000000001
10000000100000000000000000000000100000001
10000000000000000000100000000000000000001
10000000000000000000100000000000000000001
10000000000000000000100000000000000000001
10000000000000000003D30000000000000000001
10000000000000000000100000000000000000001
10000000000000000000100000000000000000001
10005000000000000000100000000000000050001
10000000000000000000000000000000000000001
11111111111111111111111111111111111111111