NO ./assets/textures/doom_grid.xpm
SO ./assets/textures/doom_grid.xpm
EA ./assets/textures/doom_grid.xpm
WE ./assets/textures/doom_grid.xpm
C ./assets/textures/doom_hexagone.xpm
F ./assets/textures/doom_ground.xpm
D ./assets/textures/doom_grid.xpm
2 ./assets/textures/sprites/skull/skull1.xpm ./assets/textures/sprites/skull/skull2.xpm ./assets/textures/sprites/skull/skull3.xpm ./assets/textures/sprites/skull/skull4.xpm ./assets/textures/sprites/skull/skull5.xpm ./assets/textures/sprites/skull/skull6.xpm ./assets/textures/sprites/skull/skull7.xpm ./assets/textures/sprites/skull/skull8.xpm
3 ./assets/textures/w3d_lamp.xpm
4 ./assets/textures/sprites/burning_barrel/burning_barrel1.xpm ./assets/textures/sprites/burning_barrel/burning_barrel2.xpm ./assets/textures/sprites/burning_barrel/burning_barrel3.xpm
5 ./assets/textures/sprites/exploding_barrel/exploding_barrel15.xpm ./assets/textures/sprites/exploding_barrel/exploding_barrel2.xpm ./assets/textures/sprites/exploding_barrel/exploding_barrel3.xpm ./assets/textures/sprites/exploding_barrel/exploding_barrel4.xpm ./assets/textures/sprites/exploding_barrel/exploding_barrel5.xpm
6 ./assets/textures/sprites/red_torch/red_torch1.xpm ./assets/textures/sprites/red_torch/red_torch2.xpm ./assets/textures/sprites/red_torch/red_torch3.xpm ./assets/textures/sprites/red_torch/red_torch4.xpm

DARK 1

11111111111111111111111111111111111111111111111111111111111111111111111111111111111111111111111111111111111111
12222222222222222222222222222222222222222222222222222222222222222222222222222222222222222222222222222222222221
12333333333333333333333333333333333333333333333333333333333333333333333333333333333333333333333333333333333321
12333433343334333133343334333433343334333133343334333433343334333133343334333433343334333133343334333433343321
12000000000000000D00000000000000000000000D00000000000000000000000D00000000000000000000000D00000000000000000021
12536353635363536153635363536353635363536153635363536353635363536153635363536353635363536153635363536353635321
123333333333333333333333333333333333333333333333333333N3333333333333333333333333333333333333333333333333333321
12536353635363536353635363536353635363536353635363536353635363536353635363536353635363536353635363536353635321
12000000000000001d10000000000000000000001d10000000000000000000001d10000000000000000000001d10000000000000000021
12333433343334333333343334333433343334333333343334333433343334333333343334333433343334333333343334333433343321
12333333333333333333333333333333333333333333333333333333333333333333333333333333333333333333333333333333333331
11111111111111111111111111111111111111111111111111111111111111111111111111111111111111111111111111111111111111