NO    ./assets/textures/w3d_redbrick.xpm
SO ./assets/textures/w3d_redbrick.xpm
EA ./assets/textures/w3d_redbrick.xpm
WE         ./assets/textures/w3d_redbrick.xpm
C ./assets/textures/w3d_redbrick.xpm
F ./assets/textures/w3d_wood.xpm
1111111
10W11
1111111
