NO    ./assets/textures/w3d_redbrick.xpm
SO ./assets/textures/w3d_redbrick.xpm
EA ./assets/textures/w3d_redbrick.xpmets/textures/w3d_redbrick.xpm
WE         ./assets/textures/w3d_redbrick.xpm
C ./assets/textures/w3d_redbrick.xpm
F ./assets/textures/w3d_wood.xpm

111111
1E000111
11110101
111100001
11111000111
11111110011
111111000111111
1111000000000011
11110001001110001
11110000011111101111
111100000000001000111
111111111111111111
