NO    ./assets/textures/w3d_wood.xpm
SO ./assets/textures/w3d_wood.xpm
EA ./assets/textures/w3d_wood.xpm
WE         ./assets/textures/w3d_wood.xpm
D ./assets/textures/w3d_door.xpm
C ./assets/textures/w3d_redbrick.xpm
F ./assets/textures/w3d_redbrick.xpm

111111
10000111
11110101
111100001
11111000111
11111110011
111111000111111
1111000000000011
11110001101110001
11110000111111101111
11110000000000100111
1111000D0D0000100111
11110E00000000100111
111100100000100011111111
1111000000000010011111111111
1111000001000010011111111111
1111000000001110111111110111
111100001111110100011111101
111100001111110100011111101111111111111111
11110000111100000000000000011111101111000111111111111
1111000011111100000000000000000000000000011
111100001111110000011111111111111111111111
1111001011111100000111
1111011011111101111111
111100001000100000111
111100000000000000111
111100000000100000111
111100010000100000111
111100000000000000111
111100000000001000111
10000000000100000111
111111111111111111
