NO    ./path1
SO ./path2
EA ./path3
WE         ./path4
C 0,12,1
F 0,4,5

1111111
10000011
111100011
   1000001
111100011
1111110011
111111000111111
   11000000000011
   10001001010001
  110E0001101111
111100000000001
111111111111111