NO    ./path1
SO ./path2
EA ./path3
WE         ./path4
C 0,12,1
F 0,4,5

1111111
1000001
10010W1
1000001
1111111