NO    ./path1
SO ./path2
EA ./path3
WE         ./path4
C 0,12,14
F 0,4,5

111111
10000111
11110101
111100001
11111000111
11111110011
111111000111111
1111S00000000011
11110001101110001
11110000111111101111
11110000000000100111
11110000000000100111
11110000000000100111
111100100000100011111111
1111000000000010011111111111
1111000001000010011111111111
11110000000001110111111110111
111100001111110100011111101
1111000011111101000111111011111111
1111000011110000011111101111000111111111111
1111000011111100000000000000000000000000011
111100001111110000011111111111111111111111
1111001011111100000111
1111011011111101111111
111100000000100000111
111100000000100000111
111100000000100000111
111100010000100000111
111100000000000000111
111100000000001000111
10000000000100000111
111111111111111111