111111
111111
1100A001111
111111
111111
111111