
1111

11111

111111
  10S1       
 1111


1111