1111
111
11N11
111



11111
110111
1 1
