11111111111111
1110000000N001
1111110000001
      10000001
11111111111111

   1