111111111
1000000 01
1000000001
111111111