111111111
1000000 01
1E00000001
111111111