1111111
1110011
1110E11
1111110