1111111
1110011
1110011
1111110