NO path1
so path2
EA path3
WE path4
C  1,3,4
F  1,43,3

11111
1011
1S11
11