NO      ./path1
SO      ./path2
EA      ./path3

C     1,45,21

F     256,23,45




WE      ./path4
11111
101101
100N11
111111