01
00001
10101
00011
111111111
0