NO    ./assets/textures/w3d_wood.xpm
SO ./assets/textures/w3d_wood.xpm
EA ./assets/textures/w3d_wood.xpm
WE         ./assets/textures/w3d_wood.xpm
D ./assets/textures/w3d_door.xpm
C ./assets/textures/w3d_redbrick.xpm
F ./assets/textures/doom_hexagone.xpm
DARK 121

111111
10000111
11110101
111100001
11111000111
11111110011
111111000111111
1111000000000011
11110001101110001
11110000111111101111
11110000000000100111
11110000000100100111
1111E000000000100111
1111000000000100011111111
11110000000100100D0000011111
1111001000000010011111001111
1111000000001110111111000111
11110000111111000011111101
111100001100D00001111111d1111111111111111
1111000011d111000000000000011111101111000111111111111
11110000D001110000000000000D000000000D00011
111100001111110000011111111111111111111111
1111001011111100000111
1111011011111101111111
111100001000100000111
111100000000000000111
111100000000100000111
111100010000100000111
111100000000000000111
111100000000001000111
10000000000100000111
111111111111111111
