NO ./assets/textures/backroom_wall2.xpm
SO ./assets/textures/backroom_wall2.xpm
EA ./assets/textures/backroom_wall2.xpm
WE ./assets/textures/backroom_wall2.xpm
F 169,137,58
C 200,180,129

11111111111111111111111111111111111111111
10000000000000000000000000000000000000001
10000000000000000000000000000000000000001
10000000000000000000100000000000000000001
10000000000000000000100000000000000000001
10000000000100000000100000000010000000001
10000000000000000000100000000000000000001
10000000000000000000100000000000000000001
10000000000000000000100000000000000000001
10000000000000000000100000000000000000001
10000000000100000000100000000010000000001
10000000000000000000100000000000000000001
10000000000000000000100000000000000000001
10000000000000000000000000000000000000001
10001000000000000000000000000000000010001
10001000000000000000000000000000000010001
10001000000000000001010000000000000010001
10001111111111111001010011111111111110001
10000000000010001011011010001000000000001
10000000000000001110001110000000000000001
10011111111000000000N00000000011111111001
10000000000000001110001110000000000000001
10000000000010001011011010001000000000001
10001111111111111001010011111111111110001
10001000000000000001010000000000000010001
10001000000000000000000000000000000010001
10001000000000000000000000000000000010001
10000000000000000000000000000000000000001
10000000000000000000100000000000000000001
10000000000000000000100000000000000000001
10000000000100000000100000000010000000001
10000000000000000000100000000000000000001
10000000000000000000100000000000000000001
10000000000000000000100000000000000000001
10000000000000000000100000000000000000001
10000000000100000000100000000010000000001
10000000000000000000100000000000000000001
10000000000000000000100000000000000000001
10000000000000000000000000000000000000001
10000000000000000000000000000000000000001
10000000000000000000000000000000000000001
11111111111111111111111111111111111111111