NO ./assets/textures/doom_hexagone.xpm
SO ./assets/textures/doom_hexagone.xpm
EA ./assets/textures/doom_hexagone.xpm
WE ./assets/textures/doom_hexagone.xpm
F 34,34,34
C 42,42,42

11111111111111111111111111111111111111111
10000000000000000000000000000000000000001
10000000000000000000100000000000000000001
10000000000000000000100000000000000000001
10000000000000000000100000000000000000001
10000000000000000000100000000000000000001
10000000000000000000100000000000000000001
10000000000000000000100000000000000000001
10000000000000000000100000000000000000001
10000000100000000000000000000000100000001
10000000010000000000000000000001000000001
10000000001000000000000000000010000000001
10000000000100000000000000000100000000001
10000000000010000000000000001000000000001
10000000000001000000000000010000000000001
10000000000000100000000000100000000000001
10000000000000010000000001000000000000001
10000000000000001000000010000000000000001
10000000000000000000000000000000000000001
10000000000000000000000000000000000000001
10000000011111100000N00000111111000000001
10000000000000000000000000000000000000001
10000000000000000000000000000000000000001
10000000000000000000000000000000000000001
10000000000000001000000010000000000000001
10000000000000010000000001000000000000001
10000000000000100000000000100000000000001
10000000000001000000000000010000000000001
10000000000010000000000000001000000000001
10000000000100000000000000000100000000001
10000000001000000000000000000010000000001
10000000010000000000000000000001000000001
10000000100000000000000000000000100000001
10000000000000000000100000000000000000001
10000000000000000000100000000000000000001
10000000000000000000100000000000000000001
10000000000000000000100000000000000000001
10000000000000000000100000000000000000001
10000000000000000000100000000000000000001
10000000000000000000100000000000000000001
10000000000000000000000000000000000000001
11111111111111111111111111111111111111111